20 18
1 7 
1 1 1 1 1 1 1 1 1 1 1 1 1 1 1 1 1 1
1 1 0 0 3 0 0 1 1 1 1 1 1 1 1 1 1 1
1 1 0 1 1 0 1 1 7 0 0 0 0 0 0 1 1 1
1 1 0 1 1 0 1 1 0 1 1 0 1 1 0 1 1 1
1 1 0 0 0 0 0 0 0 1 1 0 1 1 0 1 1 1
1 1 0 1 1 0 1 1 0 1 1 0 1 1 0 1 1 1
1 1 0 1 1 0 1 1 0 1 1 0 1 1 0 1 1 1
1 0 2 0 0 3 0 7 0 1 1 0 1 1 5 1 1 1
1 1 0 1 1 0 1 1 0 1 1 0 1 1 0 1 1 1
1 1 3 1 1 0 1 1 0 1 1 0 0 0 0 1 1 1
1 1 0 1 1 0 0 2 0 0 0 1 1 1 0 1 1 1
1 1 0 1 1 0 1 1 0 1 0 1 1 1 2 0 0 1
1 1 0 1 1 0 1 1 0 1 0 1 1 1 0 1 1 1
1 1 0 1 1 0 0 0 0 1 0 1 1 1 0 1 1 1
1 1 0 1 1 1 1 1 0 1 6 0 0 0 0 1 1 1
1 1 2 0 0 0 0 1 0 1 1 0 1 1 0 1 1 1
1 1 1 1 0 1 1 1 0 1 1 0 1 1 0 1 1 1
1 1 1 1 0 0 6 0 0 1 1 0 0 1 0 0 0 1
1 1 1 1 1 1 1 1 1 1 1 1 1 1 1 1 0 1
1 1 1 1 1 1 1 1 1 1 1 1 1 1 1 1 8 1
